epoch,time,training_cost,test_cost,shape_training_cost,size_training_cost,color_training_cost,shape_test_cost,size_test_cost,color_test_cost,shape_training_accuracy,size_training_accuracy,color_training_accuracy,shape_test_accuracy,size_test_accuracy,color_test_accuracy,monomino_training_accuracy,domino_training_accuracy,tromino1_training_accuracy,tromino2_training_accuracy,tetromino1_training_accuracy,tetromino2_training_accuracy,tetromino3_training_accuracy,tetromino4_training_accuracy,tetromino5_training_accuracy,1_training_accuracy,2_training_accuracy,3_training_accuracy,4_training_accuracy,black_training_accuracy,white_training_accuracy,red_training_accuracy,blue_training_accuracy,green_training_accuracy,yellow_training_accuracy,cyan_training_accuracy,magenta_training_accuracy,monomino_test_accuracy,domino_test_accuracy,tromino1_test_accuracy,tromino2_test_accuracy,tetromino1_test_accuracy,tetromino2_test_accuracy,tetromino3_test_accuracy,tetromino4_test_accuracy,tetromino5_test_accuracy,1_test_accuracy,2_test_accuracy,3_test_accuracy,4_test_accuracy,black_test_accuracy,white_test_accuracy,red_test_accuracy,blue_test_accuracy,green_test_accuracy,yellow_test_accuracy,cyan_test_accuracy,magenta_test_accuracy
0,0,0.1875000223,0.1875008312,0.06250001272,0.0625,0.06250000954,0.06250055101,0.06249998212,0.06250029802,0.125,0.625,0.125,0,0,0.125,0,0,0,nan,0,1,0,0,0,0,0,0,1,0,0,1,0,0,0,0,0,nan,nan,nan,0,nan,nan,nan,nan,nan,nan,nan,0,nan,0,0,1,0,0,0,0,0
25,6.914224195,0.02767708984,0.1438310045,0.0270109219,0.0006558614224,1.03E-05,0.135008208,0.008822700381,9.61E-08,0.635625,0.9996875,1,0,0.975,1,1,1,0.9975,nan,0.44125,0.4475,0.48375,0.36125,0.35375,1,1,0.9975,1,1,1,1,1,1,1,1,1,nan,nan,nan,0,nan,nan,nan,nan,nan,nan,nan,0.975,nan,1,1,1,1,1,1,1,1
50,9.827001791,0.01653962821,0.1741900915,0.01652747154,9.39E-06,2.77E-06,0.1734246466,0.0007653981913,4.68E-08,0.8321875,1,1,0,1,1,1,1,1,nan,0.78375,0.86875,0.56625,0.61375,0.825,1,1,1,1,1,1,1,1,1,1,1,1,nan,nan,nan,0,nan,nan,nan,nan,nan,nan,nan,1,nan,1,1,1,1,1,1,1,1
75,9.525493841,0.01080060549,0.1857678672,0.01079491191,3.86E-06,1.83E-06,0.1842065811,0.001561235916,5.02E-08,0.90328125,1,1,0,1,1,1,1,1,nan,0.90125,0.92875,0.69875,0.77,0.9275,1,1,1,1,1,1,1,1,1,1,1,1,nan,nan,nan,0,nan,nan,nan,nan,nan,nan,nan,1,nan,1,1,1,1,1,1,1,1
100,12.05931929,0.0064664624,0.191824546,0.006462751495,2.14E-06,1.58E-06,0.18854599,0.00327853933,1.67E-08,0.94453125,1,1,0,1,1,1,1,1,nan,0.9325,0.95375,0.89,0.825,0.955,1,1,1,1,1,1,1,1,1,1,1,1,nan,nan,nan,0,nan,nan,nan,nan,nan,nan,nan,1,nan,1,1,1,1,1,1,1,1
125,9.347123995,0.004161943894,0.1946696544,0.004160413477,9.08E-07,6.22E-07,0.1926216337,0.002048008703,1.20E-08,0.9640625,1,1,0,1,1,1,1,1,nan,0.9525,0.96875,0.97625,0.85375,0.96125,1,1,1,1,1,1,1,1,1,1,1,1,nan,nan,nan,0,nan,nan,nan,nan,nan,nan,nan,1,nan,1,1,1,1,1,1,1,1
150,9.096120396,0.003653355365,0.1980766895,0.003652611574,4.44E-07,3.00E-07,0.1959639443,0.002112727985,1.72E-08,0.9678125,1,1,0,1,1,1,1,1,nan,0.9575,0.97125,0.9825,0.86625,0.965,1,1,1,1,1,1,1,1,1,1,1,1,nan,nan,nan,0,nan,nan,nan,nan,nan,nan,nan,1,nan,1,1,1,1,1,1,1,1
175,9.108037882,0.003466556539,0.2005111948,0.003466136985,2.46E-07,1.74E-07,0.1983834373,0.002127747424,1.01E-08,0.9696875,1,1,0,1,1,1,1,1,nan,0.9575,0.97375,0.9825,0.8775,0.96625,1,1,1,1,1,1,1,1,1,1,1,1,nan,nan,nan,0,nan,nan,nan,nan,nan,nan,nan,1,nan,1,1,1,1,1,1,1,1
200,9.252376518,0.003169953875,0.2010568541,0.003169622421,2.17E-07,1.14E-07,0.1991648356,0.001892011613,6.84E-09,0.9721875,1,1,0,1,1,1,1,1,nan,0.95875,0.975,0.9925,0.88375,0.9675,1,1,1,1,1,1,1,1,1,1,1,1,nan,nan,nan,0,nan,nan,nan,nan,nan,nan,nan,1,nan,1,1,1,1,1,1,1,1
225,9.133179636,0.002997403324,0.2017537934,0.002997210291,1.09E-07,8.40E-08,0.1999231974,0.001830590703,5.27E-09,0.9734375,1,1,0,1,1,1,1,1,nan,0.95875,0.975,1,0.885,0.96875,1,1,1,1,1,1,1,1,1,1,1,1,nan,nan,nan,0,nan,nan,nan,nan,nan,nan,nan,1,nan,1,1,1,1,1,1,1,1
250,9.077711525,0.0029665143,0.202859707,0.002966376675,7.85E-08,5.91E-08,0.201118554,0.00174114909,3.91E-09,0.97375,1,1,0,1,1,1,1,1,nan,0.96,0.975,1,0.88625,0.96875,1,1,1,1,1,1,1,1,1,1,1,1,nan,nan,nan,0,nan,nan,nan,nan,nan,nan,nan,1,nan,1,1,1,1,1,1,1,1
275,9.526529322,0.002775503048,0.2036877868,0.00277538591,7.21E-08,4.51E-08,0.2017979304,0.001889852434,3.96E-09,0.9753125,1,1,0,1,1,1,1,1,nan,0.96125,0.98125,1,0.89125,0.96875,1,1,1,1,1,1,1,1,1,1,1,1,nan,nan,nan,0,nan,nan,nan,nan,nan,nan,nan,1,nan,1,1,1,1,1,1,1,1
300,9.410390282,0.002707224908,0.2058158912,0.002707133293,5.58E-08,3.59E-08,0.2030067656,0.002809122577,3.06E-09,0.9759375,1,1,0,1,1,1,1,1,nan,0.96125,0.98125,1,0.89375,0.97125,1,1,1,1,1,1,1,1,1,1,1,1,nan,nan,nan,0,nan,nan,nan,nan,nan,nan,nan,1,nan,1,1,1,1,1,1,1,1
325,9.236182051,0.002686510375,0.2059247619,0.00268644015,4.20E-08,2.82E-08,0.2034895579,0.002435201406,2.55E-09,0.97609375,1,1,0,1,1,1,1,1,nan,0.96125,0.98125,1,0.895,0.97125,1,1,1,1,1,1,1,1,1,1,1,1,nan,nan,nan,0,nan,nan,nan,nan,nan,nan,nan,1,nan,1,1,1,1,1,1,1,1
350,9.093378201,0.00263550278,0.2056028143,0.002635447184,3.24E-08,2.32E-08,0.2038393868,0.001763425209,2.22E-09,0.97640625,1,1,0,1,1,1,1,1,nan,0.96125,0.98125,1,0.8975,0.97125,1,1,1,1,1,1,1,1,1,1,1,1,nan,nan,nan,0,nan,nan,nan,nan,nan,nan,nan,1,nan,1,1,1,1,1,1,1,1
375,9.046840315,0.002564318535,0.2057271591,0.002564272351,2.69E-08,1.93E-08,0.2041317622,0.001595393196,3.70E-09,0.97703125,1,1,0,1,1,1,1,1,nan,0.9625,0.98125,1,0.90125,0.97125,1,1,1,1,1,1,1,1,1,1,1,1,nan,nan,nan,0,nan,nan,nan,nan,nan,nan,nan,1,nan,1,1,1,1,1,1,1,1
400,9.096494074,0.002514688091,0.2064072486,0.002514648438,2.30E-08,1.67E-08,0.2049942864,0.00141295772,4.47E-09,0.9775,1,1,0,1,1,1,1,1,nan,0.9625,0.98125,1,0.905,0.97125,1,1,1,1,1,1,1,1,1,1,1,1,nan,nan,nan,0,nan,nan,nan,nan,nan,nan,nan,1,nan,1,1,1,1,1,1,1,1
425,9.082278433,0.002444584413,0.206596945,0.002444550196,2.01E-08,1.41E-08,0.2053283479,0.001268592477,4.61E-09,0.978125,1,1,0,1,1,1,1,1,nan,0.965,0.98125,1,0.9075,0.97125,1,1,1,1,1,1,1,1,1,1,1,1,nan,nan,nan,0,nan,nan,nan,nan,nan,nan,nan,1,nan,1,1,1,1,1,1,1,1
450,11.91699072,0.002343153445,0.2069802775,0.002343121899,1.92E-08,1.24E-08,0.2057508892,0.001229383983,4.23E-09,0.9790625,1,1,0,1,1,1,1,1,nan,0.965,0.9825,1,0.9125,0.9725,1,1,1,1,1,1,1,1,1,1,1,1,nan,nan,nan,0,nan,nan,nan,nan,nan,nan,nan,1,nan,1,1,1,1,1,1,1,1
475,9.360805807,0.002342375443,0.2072476896,0.002342349423,1.53E-08,1.07E-08,0.2061843448,0.001063341461,3.37E-09,0.9790625,1,1,0,1,1,1,1,1,nan,0.965,0.9825,1,0.9125,0.9725,1,1,1,1,1,1,1,1,1,1,1,1,nan,nan,nan,0,nan,nan,nan,nan,nan,nan,nan,1,nan,1,1,1,1,1,1,1,1
500,9.154802399,0.002324264773,0.2080939537,0.002324242327,1.31E-08,9.35E-09,0.2069673114,0.001126639359,2.88E-09,0.97921875,1,1,0,1,1,1,1,1,nan,0.965,0.9825,1,0.91375,0.9725,1,1,1,1,1,1,1,1,1,1,1,1,nan,nan,nan,0,nan,nan,nan,nan,nan,nan,nan,1,nan,1,1,1,1,1,1,1,1
525,9.096713362,0.002257039022,0.2081360901,0.002257017824,1.29E-08,8.31E-09,0.2071084976,0.001027590316,2.21E-09,0.97984375,1,1,0,1,1,1,1,1,nan,0.965,0.98375,1,0.915,0.975,1,1,1,1,1,1,1,1,1,1,1,1,nan,nan,nan,0,nan,nan,nan,nan,nan,nan,nan,1,nan,1,1,1,1,1,1,1,1
550,9.147844849,0.002256652028,0.2081561539,0.00225663397,1.07E-08,7.38E-09,0.2072442796,0.0009118722752,1.99E-09,0.97984375,1,1,0,1,1,1,1,1,nan,0.965,0.98375,1,0.915,0.975,1,1,1,1,1,1,1,1,1,1,1,1,nan,nan,nan,0,nan,nan,nan,nan,nan,nan,nan,1,nan,1,1,1,1,1,1,1,1
575,9.146743441,0.002256224383,0.2083516166,0.002256208526,9.29E-09,6.57E-09,0.2075067944,0.0008448204957,1.68E-09,0.97984375,1,1,0,1,1,1,1,1,nan,0.965,0.98375,1,0.915,0.975,1,1,1,1,1,1,1,1,1,1,1,1,nan,nan,nan,0,nan,nan,nan,nan,nan,nan,nan,1,nan,1,1,1,1,1,1,1,1
600,9.14598176,0.002239266663,0.2085744085,0.002239252461,8.33E-09,5.87E-09,0.207811292,0.0007631150074,1.44E-09,0.98,1,1,0,1,1,1,1,1,nan,0.965,0.98375,1,0.91625,0.975,1,1,1,1,1,1,1,1,1,1,1,1,nan,nan,nan,0,nan,nan,nan,nan,nan,nan,nan,1,nan,1,1,1,1,1,1,1,1
625,9.15796833,0.002239229118,0.2087786579,0.002239216434,7.41E-09,5.28E-09,0.2080669827,0.0007116740104,1.23E-09,0.98,1,1,0,1,1,1,1,1,nan,0.965,0.98375,1,0.91625,0.975,1,1,1,1,1,1,1,1,1,1,1,1,nan,nan,nan,0,nan,nan,nan,nan,nan,nan,nan,1,nan,1,1,1,1,1,1,1,1
650,9.118139849,0.002239199788,0.2089785844,0.002239188353,6.66E-09,4.78E-09,0.2083084742,0.0006701091304,1.08E-09,0.98,1,1,0,1,1,1,1,1,nan,0.965,0.98375,1,0.91625,0.975,1,1,1,1,1,1,1,1,1,1,1,1,nan,nan,nan,0,nan,nan,nan,nan,nan,nan,nan,1,nan,1,1,1,1,1,1,1,1
675,9.37724308,0.002239176457,0.2091729737,0.002239166101,6.01E-09,4.35E-09,0.2085424847,0.0006304880604,9.63E-10,0.98,1,1,0,1,1,1,1,1,nan,0.965,0.98375,1,0.91625,0.975,1,1,1,1,1,1,1,1,1,1,1,1,nan,nan,nan,0,nan,nan,nan,nan,nan,nan,nan,1,nan,1,1,1,1,1,1,1,1
700,9.318795481,0.002239143202,0.2093495364,0.002239133782,5.45E-09,3.97E-09,0.2087579303,0.0005916052032,8.58E-10,0.98,1,1,0,1,1,1,1,1,nan,0.965,0.98375,1,0.91625,0.975,1,1,1,1,1,1,1,1,1,1,1,1,nan,nan,nan,0,nan,nan,nan,nan,nan,nan,nan,1,nan,1,1,1,1,1,1,1,1
725,9.248839197,0.002239113776,0.2095092767,0.002239105172,4.97E-09,3.64E-09,0.2089429008,0.0005663751159,7.90E-10,0.98,1,1,0,1,1,1,1,1,nan,0.965,0.98375,1,0.91625,0.975,1,1,1,1,1,1,1,1,1,1,1,1,nan,nan,nan,0,nan,nan,nan,nan,nan,nan,nan,1,nan,1,1,1,1,1,1,1,1
750,10.55032404,0.0022390805,0.2097134047,0.002239072588,4.57E-09,3.35E-09,0.209176,0.0005374040455,7.13E-10,0.98,1,1,0,1,1,1,1,1,nan,0.965,0.98375,1,0.91625,0.975,1,1,1,1,1,1,1,1,1,1,1,1,nan,nan,nan,0,nan,nan,nan,nan,nan,nan,nan,1,nan,1,1,1,1,1,1,1,1
775,13.37684913,0.002239037486,0.2098605392,0.002239030202,4.19E-09,3.09E-09,0.2093475342,0.0005130043719,6.63E-10,0.98,1,1,0,1,1,1,1,1,nan,0.965,0.98375,1,0.91625,0.975,1,1,1,1,1,1,1,1,1,1,1,1,nan,nan,nan,0,nan,nan,nan,nan,nan,nan,nan,1,nan,1,1,1,1,1,1,1,1
800,18.81187943,0.002238965953,0.2100302228,0.002238959206,3.88E-09,2.86E-09,0.2095410241,0.0004891980905,6.16E-10,0.98,1,1,0,1,1,1,1,1,nan,0.965,0.98375,1,0.91625,0.975,1,1,1,1,1,1,1,1,1,1,1,1,nan,nan,nan,0,nan,nan,nan,nan,nan,nan,nan,1,nan,1,1,1,1,1,1,1,1
825,18.40953556,0.002238793242,0.2101169557,0.002238787015,3.56E-09,2.66E-09,0.209642156,0.000474799145,5.71E-10,0.98,1,1,0,1,1,1,1,1,nan,0.965,0.98375,1,0.91625,0.975,1,1,1,1,1,1,1,1,1,1,1,1,nan,nan,nan,0,nan,nan,nan,nan,nan,nan,nan,1,nan,1,1,1,1,1,1,1,1
850,18.23166429,0.002225486949,0.2102174448,0.002225481139,3.32E-09,2.49E-09,0.2097516802,0.0004657641519,5.24E-10,0.9803125,1,1,0,1,1,1,1,1,nan,0.965,0.98375,1,0.91875,0.975,1,1,1,1,1,1,1,1,1,1,1,1,nan,nan,nan,0,nan,nan,nan,nan,nan,nan,nan,1,nan,1,1,1,1,1,1,1,1
875,18.78165443,0.002204048828,0.2103458936,0.00220404307,3.32E-09,2.44E-09,0.2098793454,0.0004665477667,5.13E-10,0.9803125,1,1,0,1,1,1,1,1,nan,0.965,0.98375,1,0.91875,0.975,1,1,1,1,1,1,1,1,1,1,1,1,nan,nan,nan,0,nan,nan,nan,nan,nan,nan,nan,1,nan,1,1,1,1,1,1,1,1
900,17.719683,0.002186998858,0.2104105686,0.002186993361,3.17E-09,2.32E-09,0.2099504471,0.000460120989,5.41E-10,0.98046875,1,1,0,1,1,1,1,1,nan,0.965,0.98375,1,0.92,0.975,1,1,1,1,1,1,1,1,1,1,1,1,nan,nan,nan,0,nan,nan,nan,nan,nan,nan,nan,1,nan,1,1,1,1,1,1,1,1
925,16.69005068,0.00218695596,0.2105479238,0.002186950843,2.94E-09,2.18E-09,0.2101094776,0.0004384457134,5.23E-10,0.98046875,1,1,0,1,1,1,1,1,nan,0.965,0.98375,1,0.92,0.975,1,1,1,1,1,1,1,1,1,1,1,1,nan,nan,nan,0,nan,nan,nan,nan,nan,nan,nan,1,nan,1,1,1,1,1,1,1,1
950,16.52187405,0.002186881846,0.2106771266,0.002186877065,2.74E-09,2.05E-09,0.2102597978,0.0004173282068,5.06E-10,0.98046875,1,1,0,1,1,1,1,1,nan,0.965,0.98375,1,0.92,0.975,1,1,1,1,1,1,1,1,1,1,1,1,nan,nan,nan,0,nan,nan,nan,nan,nan,nan,nan,1,nan,1,1,1,1,1,1,1,1
975,15.90130397,0.002186623779,0.2107895909,0.002186619308,2.55E-09,1.92E-09,0.2103895611,0.0004000293091,4.79E-10,0.98046875,1,1,0,1,1,1,1,1,nan,0.965,0.98375,1,0.92,0.975,1,1,1,1,1,1,1,1,1,1,1,1,nan,nan,nan,0,nan,nan,nan,nan,nan,nan,nan,1,nan,1,1,1,1,1,1,1,1
1000,14.71233725,0.002169358613,0.2108883164,0.002169354359,2.42E-09,1.83E-09,0.2104954614,0.0003928546328,4.54E-10,0.980625,1,1,0,1,1,1,1,1,nan,0.965,0.98375,1,0.92125,0.975,1,1,1,1,1,1,1,1,1,1,1,1,nan,nan,nan,0,nan,nan,nan,nan,nan,nan,nan,1,nan,1,1,1,1,1,1,1,1
1000,0,0.2101685531,0.2101685531,0.2095461528,0.0006223005801,9.98E-08,0.2095461528,0.0006223005801,9.98E-08,0,1,1,0,1,1,nan,nan,nan,0,nan,nan,nan,nan,nan,nan,nan,1,nan,1,1,1,1,1,1,1,1,nan,nan,nan,0,nan,nan,nan,nan,nan,nan,nan,1,nan,1,1,1,1,1,1,1,1
1025,0.8130482006,0.0001389331111,0.0001389330945,0.0001389249,5.99E-09,2.22E-09,0.0001389248835,5.99E-09,2.22E-09,0.99875,1,1,0.99875,1,1,nan,nan,nan,0.99875,nan,nan,nan,nan,nan,nan,nan,1,nan,1,1,1,1,1,1,1,1,nan,nan,nan,0.99875,nan,nan,nan,nan,nan,nan,nan,1,nan,1,1,1,1,1,1,1,1
1050,0.9072179127,0.0001388907412,0.0001388904928,0.0001388882515,1.81E-09,6.80E-10,0.0001388880031,1.81E-09,6.80E-10,0.99875,1,1,0.99875,1,1,nan,nan,nan,0.99875,nan,nan,nan,nan,nan,nan,nan,1,nan,1,1,1,1,1,1,1,1,nan,nan,nan,0.99875,nan,nan,nan,nan,nan,nan,nan,1,nan,1,1,1,1,1,1,1,1
1075,0.9145051289,0.0001388851667,0.0001388854565,0.0001388839384,8.97E-10,3.31E-10,0.0001388842281,8.97E-10,3.31E-10,0.99875,1,1,0.99875,1,1,nan,nan,nan,0.99875,nan,nan,nan,nan,nan,nan,nan,1,nan,1,1,1,1,1,1,1,1,nan,nan,nan,0.99875,nan,nan,nan,nan,nan,nan,nan,1,nan,1,1,1,1,1,1,1,1
1100,1.008045559,0.000138883687,0.0001388835215,0.000138882945,5.43E-10,1.99E-10,0.0001388827794,5.43E-10,1.99E-10,0.99875,1,1,0.99875,1,1,nan,nan,nan,0.99875,nan,nan,nan,nan,nan,nan,nan,1,nan,1,1,1,1,1,1,1,1,nan,nan,nan,0.99875,nan,nan,nan,nan,nan,nan,nan,1,nan,1,1,1,1,1,1,1,1
1125,1.145853281,0.0001388826605,0.0001388825446,0.0001388821585,3.67E-10,1.35E-10,0.0001388820426,3.67E-10,1.35E-10,0.99875,1,1,0.99875,1,1,nan,nan,nan,0.99875,nan,nan,nan,nan,nan,nan,nan,1,nan,1,1,1,1,1,1,1,1,nan,nan,nan,0.99875,nan,nan,nan,nan,nan,nan,nan,1,nan,1,1,1,1,1,1,1,1
1150,1.106698236,0.0001388820929,0.0001388820929,0.0001388817281,2.66E-10,9.93E-11,0.0001388817281,2.66E-10,9.93E-11,0.99875,1,1,0.99875,1,1,nan,nan,nan,0.99875,nan,nan,nan,nan,nan,nan,nan,1,nan,1,1,1,1,1,1,1,1,nan,nan,nan,0.99875,nan,nan,nan,nan,nan,nan,nan,1,nan,1,1,1,1,1,1,1,1
1175,1.390421801,0.0001388817172,0.0001388816427,0.0001388814383,2.02E-10,7.69E-11,0.0001388813638,2.02E-10,7.69E-11,0.99875,1,1,0.99875,1,1,nan,nan,nan,0.99875,nan,nan,nan,nan,nan,nan,nan,1,nan,1,1,1,1,1,1,1,1,nan,nan,nan,0.99875,nan,nan,nan,nan,nan,nan,nan,1,nan,1,1,1,1,1,1,1,1
1200,1.444621801,0.0001388813283,0.0001388813201,0.0001388811072,1.59E-10,6.20E-11,0.0001388810989,1.59E-10,6.20E-11,0.99875,1,1,0.99875,1,1,nan,nan,nan,0.99875,nan,nan,nan,nan,nan,nan,nan,1,nan,1,1,1,1,1,1,1,1,nan,nan,nan,0.99875,nan,nan,nan,nan,nan,nan,nan,1,nan,1,1,1,1,1,1,1,1
1225,1.592122393,0.0001388811553,0.000138881147,0.0001388809747,1.29E-10,5.14E-11,0.0001388809664,1.29E-10,5.14E-11,0.99875,1,1,0.99875,1,1,nan,nan,nan,0.99875,nan,nan,nan,nan,nan,nan,nan,1,nan,1,1,1,1,1,1,1,1,nan,nan,nan,0.99875,nan,nan,nan,nan,nan,nan,nan,1,nan,1,1,1,1,1,1,1,1
1250,1.728141956,0.0001388809103,0.0001388808524,0.0001388807595,1.07E-10,4.37E-11,0.0001388807015,1.07E-10,4.37E-11,0.99875,1,1,0.99875,1,1,nan,nan,nan,0.99875,nan,nan,nan,nan,nan,nan,nan,1,nan,1,1,1,1,1,1,1,1,nan,nan,nan,0.99875,nan,nan,nan,nan,nan,nan,nan,1,nan,1,1,1,1,1,1,1,1
1275,2.043359118,0.0001388807387,0.000138880689,0.0001388806105,9.04E-11,3.78E-11,0.0001388805608,9.04E-11,3.78E-11,0.99875,1,1,0.99875,1,1,nan,nan,nan,0.99875,nan,nan,nan,nan,nan,nan,nan,1,nan,1,1,1,1,1,1,1,1,nan,nan,nan,0.99875,nan,nan,nan,nan,nan,nan,nan,1,nan,1,1,1,1,1,1,1,1
1300,2.14913435,0.0001388804562,0.0001388804562,0.0001388803456,7.74E-11,3.33E-11,0.0001388803456,7.74E-11,3.33E-11,0.99875,1,1,0.99875,1,1,nan,nan,nan,0.99875,nan,nan,nan,nan,nan,nan,nan,1,nan,1,1,1,1,1,1,1,1,nan,nan,nan,0.99875,nan,nan,nan,nan,nan,nan,nan,1,nan,1,1,1,1,1,1,1,1
1325,1.980973406,0.0001388802601,0.0001388802932,0.0001388801634,6.71E-11,2.96E-11,0.0001388801965,6.71E-11,2.96E-11,0.99875,1,1,0.99875,1,1,nan,nan,nan,0.99875,nan,nan,nan,nan,nan,nan,nan,1,nan,1,1,1,1,1,1,1,1,nan,nan,nan,0.99875,nan,nan,nan,nan,nan,nan,nan,1,nan,1,1,1,1,1,1,1,1
1350,2.731933126,0.0001388800335,0.0001388800831,0.0001388799482,5.87E-11,2.66E-11,0.0001388799979,5.87E-11,2.66E-11,0.99875,1,1,0.99875,1,1,nan,nan,nan,0.99875,nan,nan,nan,nan,nan,nan,nan,1,nan,1,1,1,1,1,1,1,1,nan,nan,nan,0.99875,nan,nan,nan,nan,nan,nan,nan,1,nan,1,1,1,1,1,1,1,1
1375,2.555353317,0.0001388799083,0.0001388799083,0.0001388798323,5.19E-11,2.41E-11,0.0001388798323,5.19E-11,2.41E-11,0.99875,1,1,0.99875,1,1,nan,nan,nan,0.99875,nan,nan,nan,nan,nan,nan,nan,1,nan,1,1,1,1,1,1,1,1,nan,nan,nan,0.99875,nan,nan,nan,nan,nan,nan,nan,1,nan,1,1,1,1,1,1,1,1
1400,2.478166704,0.0001388797599,0.0001388798013,0.0001388796916,4.63E-11,2.20E-11,0.000138879733,4.63E-11,2.20E-11,0.99875,1,1,0.99875,1,1,nan,nan,nan,0.99875,nan,nan,nan,nan,nan,nan,nan,1,nan,1,1,1,1,1,1,1,1,nan,nan,nan,0.99875,nan,nan,nan,nan,nan,nan,nan,1,nan,1,1,1,1,1,1,1,1
1425,2.40705657,0.0001388795629,0.0001388795712,0.0001388795012,4.15E-11,2.03E-11,0.0001388795094,4.15E-11,2.03E-11,0.99875,1,1,0.99875,1,1,nan,nan,nan,0.99875,nan,nan,nan,nan,nan,nan,nan,1,nan,1,1,1,1,1,1,1,1,nan,nan,nan,0.99875,nan,nan,nan,nan,nan,nan,nan,1,nan,1,1,1,1,1,1,1,1
1450,2.271160803,0.0001388794249,0.0001388794249,0.0001388793687,3.75E-11,1.87E-11,0.0001388793687,3.75E-11,1.87E-11,0.99875,1,1,0.99875,1,1,nan,nan,nan,0.99875,nan,nan,nan,nan,nan,nan,nan,1,nan,1,1,1,1,1,1,1,1,nan,nan,nan,0.99875,nan,nan,nan,nan,nan,nan,nan,1,nan,1,1,1,1,1,1,1,1
1475,2.076789522,0.0001388792711,0.0001388792711,0.0001388792197,3.40E-11,1.74E-11,0.0001388792197,3.40E-11,1.74E-11,0.99875,1,1,0.99875,1,1,nan,nan,nan,0.99875,nan,nan,nan,nan,nan,nan,nan,1,nan,1,1,1,1,1,1,1,1,nan,nan,nan,0.99875,nan,nan,nan,nan,nan,nan,nan,1,nan,1,1,1,1,1,1,1,1
1500,2.052197495,0.0001388790683,0.0001388790849,0.000138879021,3.11E-11,1.63E-11,0.0001388790376,3.11E-11,1.63E-11,0.99875,1,1,0.99875,1,1,nan,nan,nan,0.99875,nan,nan,nan,nan,nan,nan,nan,1,nan,1,1,1,1,1,1,1,1,nan,nan,nan,0.99875,nan,nan,nan,nan,nan,nan,nan,1,nan,1,1,1,1,1,1,1,1
1525,2.017047882,0.0001388788826,0.0001388788661,0.0001388788389,2.85E-11,1.53E-11,0.0001388788223,2.85E-11,1.53E-11,0.99875,1,1,0.99875,1,1,nan,nan,nan,0.99875,nan,nan,nan,nan,nan,nan,nan,1,nan,1,1,1,1,1,1,1,1,nan,nan,nan,0.99875,nan,nan,nan,nan,nan,nan,nan,1,nan,1,1,1,1,1,1,1,1
1550,2.115829439,0.0001388787387,0.000138878747,0.0001388786982,2.62E-11,1.44E-11,0.0001388787064,2.62E-11,1.44E-11,0.99875,1,1,0.99875,1,1,nan,nan,nan,0.99875,nan,nan,nan,nan,nan,nan,nan,1,nan,1,1,1,1,1,1,1,1,nan,nan,nan,0.99875,nan,nan,nan,nan,nan,nan,nan,1,nan,1,1,1,1,1,1,1,1
1575,2.026225433,0.0001388785456,0.0001388785456,0.0001388785077,2.42E-11,1.36E-11,0.0001388785077,2.42E-11,1.36E-11,0.99875,1,1,0.99875,1,1,nan,nan,nan,0.99875,nan,nan,nan,nan,nan,nan,nan,1,nan,1,1,1,1,1,1,1,1,nan,nan,nan,0.99875,nan,nan,nan,nan,nan,nan,nan,1,nan,1,1,1,1,1,1,1,1
1600,2.357867279,0.0001388783279,0.0001388783279,0.0001388782925,2.25E-11,1.29E-11,0.0001388782925,2.25E-11,1.29E-11,0.99875,1,1,0.99875,1,1,nan,nan,nan,0.99875,nan,nan,nan,nan,nan,nan,nan,1,nan,1,1,1,1,1,1,1,1,nan,nan,nan,0.99875,nan,nan,nan,nan,nan,nan,nan,1,nan,1,1,1,1,1,1,1,1
1625,2.346446276,0.0001388782098,0.0001388782098,0.0001388781766,2.09E-11,1.22E-11,0.0001388781766,2.09E-11,1.22E-11,0.99875,1,1,0.99875,1,1,nan,nan,nan,0.99875,nan,nan,nan,nan,nan,nan,nan,1,nan,1,1,1,1,1,1,1,1,nan,nan,nan,0.99875,nan,nan,nan,nan,nan,nan,nan,1,nan,1,1,1,1,1,1,1,1
1650,2.332154713,0.0001388780091,0.0001388779925,0.0001388779779,1.95E-11,1.16E-11,0.0001388779614,1.95E-11,1.16E-11,0.99875,1,1,0.99875,1,1,nan,nan,nan,0.99875,nan,nan,nan,nan,nan,nan,nan,1,nan,1,1,1,1,1,1,1,1,nan,nan,nan,0.99875,nan,nan,nan,nan,nan,nan,nan,1,nan,1,1,1,1,1,1,1,1
1675,2.469209452,0.0001388777921,0.0001388778086,0.0001388777627,1.83E-11,1.11E-11,0.0001388777792,1.83E-11,1.11E-11,0.99875,1,1,0.99875,1,1,nan,nan,nan,0.99875,nan,nan,nan,nan,nan,nan,nan,1,nan,1,1,1,1,1,1,1,1,nan,nan,nan,0.99875,nan,nan,nan,nan,nan,nan,nan,1,nan,1,1,1,1,1,1,1,1
1700,2.563152227,0.0001388775918,0.0001388775918,0.000138877564,1.71E-11,1.06E-11,0.000138877564,1.71E-11,1.06E-11,0.99875,1,1,0.99875,1,1,nan,nan,nan,0.99875,nan,nan,nan,nan,nan,nan,nan,1,nan,1,1,1,1,1,1,1,1,nan,nan,nan,0.99875,nan,nan,nan,nan,nan,nan,nan,1,nan,1,1,1,1,1,1,1,1
1725,2.867099171,0.0001388773916,0.0001388773916,0.0001388773653,1.61E-11,1.02E-11,0.0001388773653,1.61E-11,1.02E-11,0.99875,1,1,0.99875,1,1,nan,nan,nan,0.99875,nan,nan,nan,nan,nan,nan,nan,1,nan,1,1,1,1,1,1,1,1,nan,nan,nan,0.99875,nan,nan,nan,nan,nan,nan,nan,1,nan,1,1,1,1,1,1,1,1
1750,3.042927952,0.0001388771253,0.0001388771336,0.0001388771004,1.51E-11,9.79E-12,0.0001388771087,1.51E-11,9.79E-12,0.99875,1,1,0.99875,1,1,nan,nan,nan,0.99875,nan,nan,nan,nan,nan,nan,nan,1,nan,1,1,1,1,1,1,1,1,nan,nan,nan,0.99875,nan,nan,nan,nan,nan,nan,nan,1,nan,1,1,1,1,1,1,1,1
1775,3.297956533,0.0001388769254,0.0001388769254,0.0001388769017,1.43E-11,9.41E-12,0.0001388769017,1.43E-11,9.41E-12,0.99875,1,1,0.99875,1,1,nan,nan,nan,0.99875,nan,nan,nan,nan,nan,nan,nan,1,nan,1,1,1,1,1,1,1,1,nan,nan,nan,0.99875,nan,nan,nan,nan,nan,nan,nan,1,nan,1,1,1,1,1,1,1,1
1800,3.587273359,0.0001388766594,0.000138876676,0.0001388766368,1.35E-11,9.07E-12,0.0001388766534,1.35E-11,9.07E-12,0.99875,1,1,0.99875,1,1,nan,nan,nan,0.99875,nan,nan,nan,nan,nan,nan,nan,1,nan,1,1,1,1,1,1,1,1,nan,nan,nan,0.99875,nan,nan,nan,nan,nan,nan,nan,1,nan,1,1,1,1,1,1,1,1
1825,3.357162752,0.000138876468,0.0001388764597,0.0001388764464,1.28E-11,8.75E-12,0.0001388764381,1.28E-11,8.75E-12,0.99875,1,1,0.99875,1,1,nan,nan,nan,0.99875,nan,nan,nan,nan,nan,nan,nan,1,nan,1,1,1,1,1,1,1,1,nan,nan,nan,0.99875,nan,nan,nan,nan,nan,nan,nan,1,nan,1,1,1,1,1,1,1,1
1850,3.290668001,0.0001388762022,0.0001388761939,0.0001388761815,1.22E-11,8.46E-12,0.0001388761732,1.22E-11,8.46E-12,0.99875,1,1,0.99875,1,1,nan,nan,nan,0.99875,nan,nan,nan,nan,nan,nan,nan,1,nan,1,1,1,1,1,1,1,1,nan,nan,nan,0.99875,nan,nan,nan,nan,nan,nan,nan,1,nan,1,1,1,1,1,1,1,1
1875,3.311687765,0.0001388759364,0.0001388759281,0.0001388759166,1.16E-11,8.19E-12,0.0001388759083,1.16E-11,8.19E-12,0.99875,1,1,0.99875,1,1,nan,nan,nan,0.99875,nan,nan,nan,nan,nan,nan,nan,1,nan,1,1,1,1,1,1,1,1,nan,nan,nan,0.99875,nan,nan,nan,nan,nan,nan,nan,1,nan,1,1,1,1,1,1,1,1
1900,3.139835567,0.0001388756707,0.0001388756624,0.0001388756517,1.11E-11,7.94E-12,0.0001388756434,1.11E-11,7.94E-12,0.99875,1,1,0.99875,1,1,nan,nan,nan,0.99875,nan,nan,nan,nan,nan,nan,nan,1,nan,1,1,1,1,1,1,1,1,nan,nan,nan,0.99875,nan,nan,nan,nan,nan,nan,nan,1,nan,1,1,1,1,1,1,1,1
1925,3.358798523,0.0001388753968,0.000138875405,0.0001388753785,1.06E-11,7.70E-12,0.0001388753868,1.06E-11,7.70E-12,0.99875,1,1,0.99875,1,1,nan,nan,nan,0.99875,nan,nan,nan,nan,nan,nan,nan,1,nan,1,1,1,1,1,1,1,1,nan,nan,nan,0.99875,nan,nan,nan,nan,nan,nan,nan,1,nan,1,1,1,1,1,1,1,1
1950,3.296556206,0.0001388751311,0.0001388751311,0.0001388751136,1.01E-11,7.48E-12,0.0001388751136,1.01E-11,7.48E-12,0.99875,1,1,0.99875,1,1,nan,nan,nan,0.99875,nan,nan,nan,nan,nan,nan,nan,1,nan,1,1,1,1,1,1,1,1,nan,nan,nan,0.99875,nan,nan,nan,nan,nan,nan,nan,1,nan,1,1,1,1,1,1,1,1
1975,3.309911642,0.0001388747994,0.0001388747994,0.0001388747825,9.63E-12,7.27E-12,0.0001388747825,9.63E-12,7.27E-12,0.99875,1,1,0.99875,1,1,nan,nan,nan,0.99875,nan,nan,nan,nan,nan,nan,nan,1,nan,1,1,1,1,1,1,1,1,nan,nan,nan,0.99875,nan,nan,nan,nan,nan,nan,nan,1,nan,1,1,1,1,1,1,1,1
2000,3.280382843,0.0001388744676,0.0001388744842,0.0001388744513,9.22E-12,7.07E-12,0.0001388744679,9.22E-12,7.07E-12,0.99875,1,1,0.99875,1,1,nan,nan,nan,0.99875,nan,nan,nan,nan,nan,nan,nan,1,nan,1,1,1,1,1,1,1,1,nan,nan,nan,0.99875,nan,nan,nan,nan,nan,nan,nan,1,nan,1,1,1,1,1,1,1,1